2 2 2 2 2 2 2 2 2 2 2 2 2 2 2 2
2 2 1 1 1 1 1 1 1 1 1 1 1 1 2 2
2 2 1 1 1 1 1 1 1 1 1 1 1 1 1 1
2 2 2 9 2 2 2 2 2 2 2 2 2 2 2 2
2 2 2 9 2 2 0 10 0 10 10 2 2 2 2 2
12 12 12 12 1 1 1 1 8 8 1 12 12 12 12 2
2 2 2 2 2 13 12 9 12 12 11 2 2 2 2 2
1 1 1 1 1 1 1 1 1 1 1 1 1 1 1 1
2 2 2 2 2 2 2 2 2 9 2 0 10 2 2 2
1 1 1 1 1 1 1 1 1 1 12 12 14 2 2 1
1 1 1 5 5 5 5 1 15 1 16 17 17 1 1 1
1 1 1 5 5 5 5 6 6 1 1 7 4 1 1 1