2 2 2 2 2 2 2 2 2 2 2 2 2 2 2 2 2 2 2 2 2 2 2 2 2 2 2 2 2 2 2 2 2 2 2 2 2 2 2 2 2 2 2 2 2 2 2 2 2 2  
2 2 2 0 10 0 10 10 2 2 2 2 2 0 10 10 0 10 0 2 2 2 2 2 0 10 18 18 18 10 10 2 2 2 2 2 2 2 2 2 0 18 18 18 10 0 10 2 2 2  
2 12 12 1 1 1 8 1 1 1 1 1 1 1 1 1 1 1 1 12 12 12 2 0 1 1 1 1 1 1 1 1 2 2 2 10 2 2 2 10 1 1 1 1 1 1 1 12 12 12  
2 2 2 13 12 9 12 11 2 2 2 2 2 13 12 12 9 12 14 2 2 2 2 1 1 1 19 1 1 19 1 1 1 1 1 1 1 1 1 1 1 5 5 5 5 5 1 2 2 2  
2 2 2 2 2 9 2 2 2 2 2 2 2 2 2 2 9 2 2 2 2 2 12 1 1 1 1 1 1 1 1 14 2 2 2 2 1 1 1 1 1 5 5 5 5 5 1 2 2 2  
2 2 2 2 2 9 2 2 2 2 2 2 2 2 2 2 9 2 2 2 2 2 2 13 12 12 12 12 12 12 12 2 2 2 16 1 1 1 1 1 1 1 1 9 1 1 1 2 2 2  
2 2 2 2 2 9 2 2 2 2 2 2 2 2 2 2 9 2 2 2 2 2 2 2 2 2 2 2 2 2 2 2 2 2 12 12 12 12 12 12 12 12 12 9 12 12 11 2 2 2  
2 18 2 2 2 9 2 18 10 2 2 2 2 2 2 2 9 2 2 2 2 2 2 2 2 2 2 2 2 2 2 2 2 2 2 2 2 2 2 2 2 2 2 9 2 2 2 2 2 2  
0 1 1 1 1 1 1 1 1 2 2 0 1 8 1 1 1 1 1 1 1 1 1 1 1 1 1 1 1 1 16 16 1 1 1 1 1 1 1 1 1 1 1 1 1 19 1 1 1 2 
13 1 16 1 8 1 16 1 1 2 2 1 8 8 1 1 1 1 1 1 1 1 1 1 16 16 16 1 1 1 1 1 1 1 1 1 1 1 1 1 1 19 1 1 1 1 1 1 19 2  
2 12 12 12 12 12 12 1 11 2 2 2 2 2 2 2 2 2 2 2 2 2 2 2 2 2 2 2 2 2 2 2 2 2 2 2 2 2 2 2 2 2 2 2 2 2 2 2 2 2  
3 3 3 3 3 3 3 1 3 3 3 3 3 3 3 2 7 7 7 7 2 0 10 0 10 2 2 0 10 0 10 10 0 10 10 10 2 1 1 1 1 1 1 1 1 1 1 1 1 1  
3 4 7 4 7 7 7 7 7 7 7 4 7 4 3 2 7 4 4 7 2 1 8 8 1 1 2 1 16 16 16 16 16 16 16 1 2 1 1 1 1 1 1 5 5 5 5 5 5 1  
3 7 17 7 7 7 7 21 7 7 7 7 17 7 3 2 7 7 7 7 2 13 12 12 1 11 2 1 1 1 1 1 1 1 1 1 2 1 1 1 1 1 1 5 2 2 2 2 5 1  
3 4 7 4 7 7 7 7 7 7 7 4 7 4 3 2 2 9 2 2 2 2 2 2 9 2 2 9 2 2 2 2 2 9 12 11 2 1 1 1 1 1 1 5 2 8 1 2 5 1   
3 7 7 7 7 7 7 21 7 7 7 7 7 7 3 0 10 9 0 10 2 2 2 17 7 7 7 7 2 0 10 2 2 9 2 2 2 1 1 1 1 1 1 5 2 1 1 1 20 1  
3 7 7 7 7 7 7 7 7 7 7 7 7 7 7 1 1 1 1 1 1 1 1 7 7 17 17 17 2 16 16 1 1 1 1 1 1 1 1 1 1 1 1 5 2 1 1 2 5 1 
3 7 7 17 17 7 7 21 7 7 17 17 7 7 3 13 12 12 11 2 12 2 2 2 2 2 2 2 2 16 16 1 1 1 5 5 5 5 5 5 5 5 5 5 2 2 2 2 5 1  
3 7 7 17 17 7 7 7 7 7 17 17 7 7 3 2 2 2 2 2 2 2 2 2 2 2 2 2 2 13 1 1 1 1 5 5 5 2 2 2 2 2 5 5 5 5 5 5 5 1   
3 7 7 7 7 7 7 21 7 7 7 7 7 7 3 0 1 1 1 1 10 2 0 1 1 1 1 1 10 2 1 1 1 1 5 5 5 2 8 8 1 2 5 5 25 25 25 25 25 1  
3 4 7 4 7 7 7 7 7 7 7 4 7 4 3 1 1 5 5 1 1 2 1 1 5 5 5 1 1 2 1 1 1 1 5 5 5 2 1 1 1 2 5 5 25 1 1 1 1 1  
3 7 17 7 7 7 7 21 7 7 7 7 17 7 3 1 1 1 1 1 1 2 1 1 1 1 1 1 1 2 1 1 1 1 5 5 5 2 2 9 2 2 5 5 25 1 1 25 1 1  
3 4 7 4 7 7 7 7 7 7 7 4 7 4 3 13 12 1 12 12 11 2 13 12 12 1 12 12 11 2 1 1 1 1 5 5 5 5 5 5 5 5 5 5 25 1 1 25 1 1  
3 3 3 3 3 3 3 7 3 3 3 3 3 3 3 24 24 1 24 24 24 24 24 24 24 1 1 1 1 1 1 1 1 1 5 5 5 5 5 5 5 5 5 5 25 1 1 25 1 1  
3 3 3 3 3 3 3 22 3 3 3 3 3 3 3 1 1 1 1 1 1 1 1 1 1 1 1 24 24 1 1 1 1 1 25 25 25 25 25 1 25 25 25 25 25 1 1 1 1 1  
3 3 3 3 3 3 3 22 3 3 3 3 3 3 3 1 1 1 1 1 1 1 1 1 1 1 1 1 1 1 1 1 1 1 1 1 1 1 1 1 1 1 1 1 1 1 1 1 1 1  
3 7 7 7 7 7 7 7 3 23 24 24 24 24 24 1 1 1 1 1 1 1 1 23 1 1 1 1 1 1 23 23 1 1 1 1 1 1 1 1 1 1 26 1 1 1 1 1 1 1  
3 7 7 7 7 7 7 7 3 23 1 1 1 1 1 1 1 8 8 8 1 1 1 23 23 1 1 1 1 1 23 23 1 1 1 1 1 1 1 1 1 1 26 26 1 1 1 1 1 25  
3 7 7 7 7 7 7 7 3 23 23 23 1 1 1 1 1 1 1 1 1 1 1 23 23 23 1 1 1 1 1 1 1 1 1 1 5 5 1 1 1 26 26 26 26 1 1 1 25 25  
3 7 7 7 7 7 7 3 3 23 23 23 1 1 1 1 1 1 1 1 1 1 1 23 23 23 1 1 1 1 23 23 1 1 1 1 5 5 1 1 1 1 1 1 1 1 1 1 25 25  
3 1 1 1 1 1 1 1 1 1 1 1 1 1 1 1 1 1 1 1 1 1 1 1 1 1 1 1 1 1 1 1 1 1 1 1 20 20 1 1 1 1 1 1 1 1 1 1 1 1  
2 2 2 2 2 2 2 2 2 2 2 2 2 2 2 2 2 2 2 2 2 2 2 2 2 2 2 2 2 2 2 2 2 2 2 2 5 5 6 6 6 6 6 6 6 6 6 6 6 6  
